NO	./path_to_the_north_texture
SO ./path_to_the_south_texture
WE ./path_to_the_west_texture
EA ./path_to_the_east_texture
F 220,75,33
C 225,66,114     





11111111
10001111
10001111
10001111
10001111
10001111
10001111
10001111
1001111
10001111
10001111
10001111
10001111
10N0111
1111111