NO  Wolf3D.png
SO  Wolf3D.png
WE  Wolf3D.png
C 92,101,105
F 39,153,245




EA  Wolf3D.png

1111111111111111111111111          
1000000000110000000000001           
10110000001110000E00000001
100100000000000000000000111111
111111101011000001110000000001
100000000011000001110011111111
11110110111 1110111000000100001
111101101111111110111010100100111
110000001101010111000000100011
100000000111111100011000000101
100000000000000000011111111111
110000011111111111111011011011
11110111111010110111101000111
  11111111 1 11111111111111111111
