NO	./path_to_the_north_texture
SO ./path_to_the_south_texture
WE ./path_to_the_west_texture
EA ./path_to_the_east_texture
F 220,75,33
C 225,66,114     





 1111111111111111111111111          
1000000000110000000000001           
1011000S001110000000000001      
10010000000000000000000011111111
11111111101100000111000000000001
10000000001100000111011111111111
11110111111 111011100000010000001
111101111 11111011101010010001111
1100000011010101110000001000111
10000000011111110001100000010001
10000000011010010001111111111111
11000001111111111111101101100111
1111011111101011011110100011111
  11111111 1 1111111111111111111111
