NO	./path_to_the_north_texture
SO ./path_to_the_south_texture
WE ./path_to_the_west_texture
EA ./path_to_the_east_texture
F 220,75,33
C 225,66,114          
111111111111111111111111
1000000000110000000000001
1011000001110000000000001                                                               
100100000000000000000000111111111
111111111011000001110000000000001
100000000011000001110111111111111
1111011111111101110000001000000001
111101111111110111010100100011111
1100000011010101110000001000111
10000000011111110001100000010001
10000000011010010001111111111111
110000011111111111111011110N0111
1111011111101011011110100011111
111111111111111111111111111
