NO	./path_to_the_north_texture
SO ./path_to_the_south_texture
WE ./path_to_the_west_texture
EA ./path_to_the_east_texture
F 220,75,33
C 225,66,114     





1111111111111111111111111          
1000000000110000000000001           
10110000001110000E00000001
100100000000000000000000111111
111111101011000001110000000001
100000000011000001110111111111
11110110111 1110111000000100001
1111011011111110111010100100111
11000000110101011100000010001
100000000111111100011000000101
100000000110100100011111111111
110000011111111111111011011011
11110111111010110111101000111
  11111111 1 11111111111111111111
