NO	./path_to_the_north_texture
SO ./path_to_the_south_texture
WE ./path_to_the_west_texture
EA ./path_to_the_east_texture
F 220,75,33
C 225,66,114          


























111111111111111111111111
1000000000110000000000001
1011000001110000000000001
100100000000000000000000111111111
111111111011 	r000001110000000000001
100000000011000001  110111111111111
11110111111111011100000010001
1111011	  1111111011101010010001
11000000110101011100000010001
10000000011111110001100000010001
10000000011010010001
1100000111111   11111111011110N0111
111101111110101101111010001
11111111111  1111111111111111