NO	./path_to_the_north_texture
SO ./path_to_the_south_texture
WE ./path_to_the_west_texture
EA ./path_to_the_east_texture
F 220,75,33
C 225,66,114     





1111111111111111111111111          
1000000W00110000000000001           
10110000001110000000000001      
10010000000000000000000011111
11111110101100000111000000001
10000000001100000111011111111
11110110111 111011100000010001
111101101111111011101010010011
11000000110101011100000010001
10000000011111110001100000011
10000000011010010001111111111
11000001111111111111101101101
1111011111101011011110100011
  11111111 1 1111111111111111111