NO  Wolf3D.png
SO  nazi.png
WE  BRICK.png
EA  hitler.png
C 92, 1,01,105
F 39, 153,245





 1111
 1S01
10001
10001
1001
10001
10001
1011
10001
10001
10001
10001
10001
10001
10001               
10001            
100011111                 
10001
10001
10001
10001
10001
10001
10001
11111