NO  Wolf3D.png
SO  nazi.png
WE  BRICK.png
EA  hitler.png
C 92,101,105
F 39,153,245






1111111111111111111111111111          
1000000000110000000000001           
1011000000111000000000001
100100000000000000000000111111
111111101011000001110000000001
100000000011000001110011111111
111101101111110111000000100001
1111011011111111101110101001001
1100000011010101110000001000111
1000000001111111000110000001011
1000000000000000000111111111111
1100000111111111111110110110111
1111011111101011011110100011111
111111111111111111111111111111
1111111111111111111111111111          
1000000000110000000000001           
1011000000111000000000001
100100000000000000000000111111
111111101011000001110000000001
100000000011000001110011111111
111101101111110111000000100001
1111011011111111101110101001001
1100000011010101110000001000111
1000000001111111000110000001011
1000000000000000000111111111111
1100000111111111111110110110111
1111011111101011011110100011111
111111111111111111111111111111
1111111111111111111111111111          
1000000000110000000000001           
1011000000111000000000001
100100000000000000000000111111
111111101011000001110000000001
100000000011000001110011111111
111101101111110111000000100001
1111011011111111101110101001001
1100000011010101110000001000111
1000000001111111000110000001011
1000000000000000000111111111111
1100000111111111111110110110111
1111011111101011011110100011111
111111111111111111111111111111
1111111111111111111111111111          
1000000000110000000000001           
1011000000111000000000001
100100000000000000000000111111
111111101011000001110000000001
100000000011000001110011111111
111101101111110111000000100001
1111011011111111101110101001001
1100000011010101110000001000111
1000000001111111000110000001011
1000000000000000000111111111111
1100000111111111111110110110111
1111011111101011011110100011111
111111111111111111111111111111
1111111111111111111111111111          
1000000000110000000000001           
1011000000111000000000001
100100000000000000000000111111
111111101011000001110000000001
100000000011000001110011111111
111101101111110111000000100001
1111011011111111101110101001001
1100000011010101110000001000111
1000000001111111000110000001011
1000000000000000000111111111111
1100000111111111111110110110111
1111011111101011011110100011111
111111111111111111111111111111
1111111111111111111111111111          
1000000000110000000000001           
1011000000111000000000001
100100000000000000000000111111
111111101011000001110000000001
100000000011000001110011111111
111101101111110111000000100001
1111011011111111101110101001001
1100000011010101110000001000111
1000000001111111000110000001011
1000000000000000000111111111111
1100000111111111111110110110111
1111011111101011011110100011111
111111111111111111111111111111
1111111111111111111111111111          
1000000000110000000000001           
1011000000111000000000001
100100000000000000000000111111
111111101011000001110000000001
100000000011000001110011111111
111101101111110111000000100001
1111011011111111101110101001001
1100000011010101110000001000111
1000000001111111000110000001011
1000000000000000000111111111111
1100000111111111111110110110111
1111011111101011011110100011111
111111111111111111111111111111
1111111111111111111111111111          
1000000000110000000000001           
1011000000111000000000001
100100000000000000000000111111
111111101011000001110000000001
10000000001100N0001110011111111
111101101111110111000000100001
1111011011111111101110101001001
1100000011010101110000001000111
1000000001111111000110000001011
1000000000000000000111111111111
1100000111111111111110110110111
1111011111101011011110100011111
111111111111111111111111111111
1111111111111111111111111111          
1000000000110000000000001           
1011000000111000000000001
100100000000000000000000111111
111111101011000001110000000001
100000000011000001110011111111
111101101111110111000000100001
1111011011111111101110101001001
1100000011010101110000001000111
1000000001111111000110000001011
1000000000000000000111111111111
1100000111111111111110110110111
1111011111101011011110100011111
111111111111111111111111111111
1111111111111111111111111111          
1000000000110000000000001           
1011000000111000000000001
100100000000000000000000111111
111111101011000001110000000001
100000000011000001110011111111
111101101111110111000000100001
1111011011111111101110101001001
1100000011010101110000001000111
1000000001111111000110000001011
1000000000000000000111111111111
1100000111111111111110110110111
1111011111101011011110100011111
111111111111111111111111111111
